Monkey - Banana Split
Terrier - Waffles
Pig - Pumpkin Mash
Plain Runner - Milk Chocolate Bar
Jungle Runner - Mint Chocolate Bar
Desert Runner - Caramel Chocolate Bar
Snow Runner - White Chocolate Bar
Collie - Bubble-gum
Sheep - Cotton Candy
Slime - Jelly
Hornet - Popcorn
Mole - Chocolate Donut
Chicken - Cereal Bar
Bunny - Carrot
Horse - Candied Apple
Lemon Beetle - Lemon Tart
Turtle - Cinnamon Roll
Crab - Strawberry Cocktail
Duckbill - Sugar Candy
Crocodile - Apple Rings
Raccoons - Chocolate Cake
Squirrel - Strawberry Cake
Crow - Liquorice Candy
Alpaca - Vanilla Cupcake
Brown Alpaca - Chocolate Cupcake
Porcupine - Blackberry Marmalade
Camel - Date Cookie
Penguin - Softice
Black Cat - Candy
Bat - Mango Juice
Fly - Fruit Basket
Bark Beetle - Bread
Seagull - Salted Caramel
Spitter - Water Ice
Owl - Lollipop
Parrot - Ginger Tartlets
Midge - Melon Ice Cream
Peacocks - Chocolate Cookie
Biters - Pancakes
Snout Beetle - Lolly
Scottish terrier - Croissant
Mosquito - Bloodorange Juice